a_gilles = Aurélien Gilles <a_gilles@users.sourceforge.net>
aag07r = Ali Gondal <aag07r@users.sourceforge.net>
aedmunds = Andy Edmunds <aedmunds@users.sourceforge.net>
aenbacka = Andreas Enbacka <aenbacka@users.sourceforge.net>
amchaarh = Hicham Amchaar <amchaarh@users.sourceforge.net>
aniaouris = aniaouris <aniaouris@users.sourceforge.net>
arequet = Antoine Requet <arequet@users.sourceforge.net>
beatboxrocka = Joseph Ruskiewicz <beatboxrocka@users.sourceforge.net>
billaude = Emmanuel Billaud <billaude@users.sourceforge.net>
carinepascal = Carine Pascal <carinepascal@users.sourceforge.net>
cavagnabertrand = Bertrand Cavagna <cavagnabertrand@users.sourceforge.net>
cfsnook = Colin Snook <cfsnook@users.sourceforge.net>
chrimetayer = Christophe Métayer <chrimetayer@users.sourceforge.net>
clabaut = Mathieu Clabaut <clabaut@users.sourceforge.net>
cponsard = Christophe Ponsard <cponsard@users.sourceforge.net>
desaperh = Hugo De Sa Pereira Pinto <desaperh@users.sourceforge.net>
dkriangs = Kriangsak Damchoom <dkriangs@users.sourceforge.net>
fabianf = Fabian Fritz <fabianf@users.sourceforge.net>
fages = Yoann Fages-Tafanelli <fages@users.sourceforge.net>
fuersta = Andreas Fürst <fuersta@users.sourceforge.net>
halstefa = Stefan Hallerstede <halstefa@users.sourceforge.net>
hmaria = Maria Husmann <hmaria@users.sourceforge.net>
iweigelt = Ingo Weigelt <iweigelt@users.sourceforge.net>
jabrial = Jean-Raymond Abrial <jabrial@users.sourceforge.net>
jastram = Michael Jastram <jastram@users.sourceforge.net>
jbendisposto = Jens Bendisposto <jbendisposto@users.sourceforge.net>
jolilius = Johan Lilius <jolilius@users.sourceforge.net>
lvoisin = Laurent Voisin <lvoisin@users.sourceforge.net>
maamria = Issam Maamria <maamria@users.sourceforge.net>
maryah = Mar Yah Said <maryah@users.sourceforge.net>
mjbutler = Michael Butler <mjbutler@users.sourceforge.net>
mleuschel = Michael Leuschel <mleuschel@users.sourceforge.net>
nicolas_beauger = Nicolas Beauger <nicolas_beauger@users.sourceforge.net>
qmalik = Qaisar Ahmad Malik <qmalik@users.sourceforge.net>
renato_silva = Renato Silva <renato_silva@users.sourceforge.net>
snursmumrik = Vitaly Savicks <snursmumrik@users.sourceforge.net>
spooky23 = Jann Röder <spooky23@users.sourceforge.net>
thanik = Thierry Lecomte <thanik@users.sourceforge.net>
thomasmuller = Thomas Muller <thomasmuller@users.sourceforge.net>
tshoang = Thai Son Hoang <tshoang@users.sourceforge.net>
wohuai = Matthias Schmalz <wohuai@users.sourceforge.net>
aptillman = Andrew Tillman <aptillman@users.sourceforge.net>
cmv205 = Christian Vollmert <cmv205@users.sourceforge.net>
dotkoni = Matthias Konrad <dotkoni@users.sourceforge.net>
fterrier = François Terrier <fterrier@users.sourceforge.net>
mehta = Farhad Mehta <mehta@users.sourceforge.net>
vitoralmeida = Vitor Alcântara de Almeida <vitoralmeida@users.sourceforge.net>
yguyot = Yoann Guyot <yguyot@users.sourceforge.net>
benoitlucet = Benoît Lucet <benoitlucet@users.sourceforge.net>
asiehsalehi = Asieh Salehi <asiehsalehi@users.sourceforge.net>
dplagge = Daniel Plagge <dplagge@users.sourceforge.net>
ladenberger = Lukas Ladenberger <ladenberger@users.sourceforge.net>
the-roy = Merlin <the-roy@users.sourceforge.net>
joybclark = Joy Clark <joybclark@users.sourceforge.net>
gs6g10 = Gintautas Sulskus <gs6g10@users.sourceforge.net>
lyhlbyl = Yuhui Lin <lyhlbyl@users.sourceforge.net>
root = Administrator <root@localhost>
(no author) = No Author <no.author@no.org>
